ADG	адыгaбзэ (Adyghe)	ady
AGL	агъул чIал (Agul)	agx
ALT	алтай тили (Altai)	atv (alt)
AVR	магӀарул мацӀ (Avar)	ava
AZE	Azärbaycanca (Azeri)	aze/azj/azb/slq/qxq
BSK	башҡорт теле (Bashkir)	bak
BEZ	бежкьалас миц (Bezhta)	kap
BUR	буряад хэлэн (Buryat)	bxr (bxm)
CHE	нохчийн мотт (Chechen)	che
CHK	ԓыгъоравэтԓьэн йиԓыйиԓ (Chukchi)	ckt
CHV	чӑвашла (Chuvash)	chv
CRT	къырымтатарджа (Crimean Tatar)	crh
DRG	дарган мез (Dargi)	dar
DNG	хуэйзў йүян (Dungan)	dng
GGZL	Gagauz dili (Gagauz)	gag
GGZLCB	Gagauz dili (Gagauz)
GGZC	гагауз дили (Gagauz)
GGZCCB	гагауз дили (Gagauz)
GRG	ქართული ენა (Georgian)	kat
KBD	адыгэбзэ (Kabardian)	kbd
KRKL	Qaraqalpaq (Karakalpak)	kaa
KRK	каракалпак (Karakalpak)
KAZ	қазақ тілі (Kazakh)	kaz
XKS	Хакас тілі (Khakas)	kjh
KUM	къумукъ тил (Kumyk)	kum
KYLSC	кыргызча (Kyrgyz)	kir
KYROHC	кыргызча (Kyrgyz)
KYLSA	قىرعىز تىلى (Kyrgyz)
KYROHA	قىرعىز تىلى (Kyrgyz)
LEZCB	лезги чІал (Lezgi)	lez
NEN	ненэцяʼ вада (Nenets)	yrk
OSS	ирон æвзаг (Ossetic)	oss
SHR	шор тили (Shor)	cjs
TBN	табасаран (Tabasaran)	tab
TJK	тоҷикӣ (Tajik)	tgk
TTR	татарчага (Tatar)	tat
TSK	цӀаӀхна миз (Tsakhur)	tkr
TKLI	Türkmençe (Turkmen)	tuk
TKL	Türkmençe (Turkmen)
TKCI	түркменче (Turkmen)
TVN	тыва дыл (Tuvan)	tyv
UZIBTL	Oʻzbekcha (Uzbek)	uzb/uzn/uzs
UZVL	Oʻzbekcha (Uzbek)
UZIBT	ўзбекча (Uzbek)
UZV	ўзбекча (Uzbek)
YKT	саха тыла (Yakut)	sah

NOG	ногай тили (Nogai)	nog